################
#    ##    ##  #
#    ##     ## #
#    ##  ##    #
##  ### ##     #
##  ##  #      #
##   #    ##   #
#    #  ####   #
#       #      #
#       #      #
#       #  #  ##
#      ##  #  ##
#      #   #####
#      #       #
################
