# ######d###########
d                  d
#        ##     ## #
#        ##  ##    #
##      ### ##     #
##      ##  #      #
##       #    ##   #
#        #  ####   #
#           #      #
#           #      #
#           #  #  ##
## ###     ##  #  ##
#          #   #####
#          #       #
#          #       #
##d#################
