########################################
#                                      #
#                  ##                  #
#                  ##                  #
#                  ##                  #
#                  ##                  #
#                  ##                  #
#                  ##                  #
#                  ##                  #
#                  ##                  #
#                  ##                  #
#                  ##                  #
#                  ##                  #
#                  ##                  #
#                  ##                  #
## ####################### #############
## ####################### #############
#                                      #
#                  ##                  #
#                  ##                  #
#                  ##                  #
#                  ##                  #
#                  ##                  #
#                  ##                  #
#                  ##                  #
#                  ##                  #
#                  ##                  #
#                  ##                  #
#                  ##                  #
#                  ##                  #
#                  ##                  #
########################################


