########################################
#                                      #
#                  ##                  #
#         ###########                  #
#                  ##    ##########    #
##############     ##                  #
#          #       ##    ###########   #
#          #       ##                  #
#          #       ##                  #
#          #       ##                  #
#          #       ##    ##########    #
#                  ##                  #
#    ############  ##   #############  #
#                  ##                  #
#                  ##                  #
## ####################### #############
## ####################### #############
#                                      #
#     ##########   ##                  #
#    ##            ##  #     ########  #
#    ##            ##  #     #         #
#     ##           ##  #     #         #
#      #######     ##  #     #         #
#            ##    ##  #               #
#             #    ##  ###########     #
#             #    ##                  #
#           ###    ##   ############   #
#    ########      ##                  #
#   ##             ##                  #
#   ###            ##                  #
#                  ##                  #
########################################

