####################
#                  #
#       ############
#                  #
#   ###########    #
#             #    #
#    #        #  ###
#### #        #    #
#             #    #
#  ########   #    #
#                  #
#    #         ##  #
#    #       ###   #
#    #########     #
#                  #
####################

