####################
#       #          #
#     ###   ##     #
#    ##       ###  #
####    #####   #  #
#  #    #    #  #  #
#  ### ##    ####  #
# #                #
# ##      #        #
#  ########    ##  #
#            ###   #
# ############     #
#              #   #
#     #########    #
#   ##             #
####################

