###############################################################################
#                      ##          ###########      ##       ####  #          #
#       #####            ##     ###      #        #   ####         #          #
#       ######            ##    ##       #        #      #   #      #    ###  #
#       ######             #     #      ##        #   #  ##  ##     #    # #  #
#       #####              #      #              ##   #  ##   #   ###    ###  #
##               ####     ##      #      #########    #       #   #      ##   #
##              ##  #######       #                   #########   #           ##
##             #                  #                               ###          #
#              #                 #          #######                 ##         #
#               ##              ##        ##      ##    ########     ##        #
#      ###       ###          ###        ##   ##   #   ##      ##     ##       #
#    ##  ###      ##    #######         ##    #    #   ##       ##      ##     #
#    #     ###                         ##    #    ##    ##       ##      ##   ##
#    ####     ##                    ####    ##    #      #        #       #   #
##      ###    #        ### #########      ##    ##      #        ##      #   #
##         #   #                           #             #    #   #     ###   #
##          ###               ###           #            #   ##   #    #      #
 ###                        ###  ####       ###        ##    #    #    #      #
    ########              ###       ##        #########     #     #    #      #
           ###                      #                       #          #      #
              ###                   ### #                   #     ######      #
               #########                 ###########       #     ##        ####
                       ########                     #######     ##        ####
                              ####                              ###      ###
                                  ###################                  ####
                                                   #########          ##
                                                          #############

